1111111111111
1001000000001
1000011111C01
110P011E00001
1111111111111
