1111111111111
1001010000001
1000000000C01
110P011E00001
1111111111111
