1111111111111
1001010000001
100000000PC01
1100010E00001
1111111111111
