1111111111111111111111111111111111
1E000000000M000C00000C000000000001
1010010100100000101001000001010101
1010010010101010001001000100010101
1P0000000C00C0000000000000000000C1
1111111111111111111111111111111111
